111111111111111111111111111111111111111111111111111
11E00100000000000C00000C000000000001110000000101011
100000010100100000101001000000010100000000000101011
100000110010101010001001000000010101110000000101011
1100000100C00C0000000000000000000C01110000000101011
11110000100001111111111111111111100111000C000000C11
1000000001000000C00000C0000010000001110000000100111
101001001011010100010010001000010101110000000010111
1C0000000C001C00000000000100000000C1110000000011111
111111000000001111110001100001111111110000001010111
111000001111111111111001011111100000000000001010111
100C000000000001C0000010000000000001110000001010111
101001010010000011010101000000010100000000001010111
1111111111111111111111111100000000C1110001111010111
11111111111100000000111111000000011111000000101C111
101001001011010100010010001000010101110000001010111
1C0000000C000C00000000000000000000C1100000001010111
111000000000000000000000011001111111100000001010111
1111111111111111111000010000000000011000000000C0111
111111111111111110000000011111111111100000001010111
101001001011010100010010001000010000000000001010111
1C0000000C001C0000000000010000000C10000001010000111
111111100001111111110000001111110000000001000000111
111111111000000110000000011111111111100000001010111
101001001000010100010010000000010011100000001010111
1C0000000C001C0000000000000000000C11100C00000C00P11
111111111111111111111111111111111111111111111111111
111111111111111111111111111111111111111111111111111