11111111111111111111111
1000PCE0000000000000001
1C0000000C00C0000000001
10000111010111111110111
1111111111C0000000000C1
10000000000000000000001
11111111111111111110001
11111111111111111111111