111111
1100C1
1C01E1
1100P1
111111